XXXXXXXXXXXXXXXXXXXXXXXXXXXXXXXXXXXXXXXXXXXXXXXXXXXXXXXXXXXX
XXOOOXOOOOOOOXXXXXXXXXXXXXXXXXXXXXXXOOOOOOOOOXOOOOOOOOOOOOXX
XOXXOXXXXXXXOOOOOOOOOOOOOOOOOOOOOOOOOXXXXXXXOXXOXXXXXXXXXOXX
XOOOOOOOOOOXXXXXXXXXXOXXXXXXXXXXXXXXXXXXXXXXOXXOXXXXXXXXXOXX
XXXOXXXXXXOXXXXXXXXXXOXXXXXXXXOOOOOXXXXXXXXXOXXOXXXXXXXXXOXX
XXXOXXOXXXOXXXXXXXXXXOXXXXXXXXXXXXOXXXXXXXXXOOOOOOOOOOOOOOOX
XXXOXXOXXXOXXXXXXXXOOOXXXXXXXXXXOOOOOOOOOOOOOOOOXXXXXXXXXXXX
XXXOXXOXXXOXXOOOOOXOXXXOOOOOOOOOOXXXXXXXXXXXXXXOXXXXXXXXXXXX
XXXOXXOXXXOXXOXXXOXOXXXXXXXXXXXXOOOOOOOOOOOOOOXOXXXXXXXXXXXX
XXXOOOOOOXOXXOXXXOXOOOOOOOOOOOOOOOXXXXXXXXXXXXXOOOOOOOOOOOXX
XXXXXXOXXXOXXOXXXOXXXXXXXXXXXXXXXOXXXXXXXXXXXXXXXXXXXXXXOXXX
XXXXXXOXXXOOOOXXXOXXXXXXXXXXXXXXXOOOOOOOOOXXXXXXXXXXXXXXOXXX
XXXXXXOXXXXXOXXXXOOOOOOOOOOOOOOOOOXXXXXXXOOOOOXXXXXXXXXXOXXX
XOOOOOOXXXXXOXXXXOXXXXXXXXXXXXXXXXXXXXXXXXXXXXOOOOOOOOXXOXXX
XXXXXXOXXXXXOXXXXOOOOOOOOOXXXXXXXXXXXXXXXXXXXXXXXXXXXXOOOXXX
XXXXXXOOOOOOOOOOOXXXXXXXXOXXXXOOOOOOOOXXOOOOOOOOOOOOOOOXXXXX
XXXXXXXXXXXXXXXXOOOOOOOXOOOOOOXXXXXXOXXOXXXXXXXXXXXXXOXXXXX
XXXXXXXXXXXXXXXXXXXXXXOOXOXXXXXXXXXXXOOOOXOOOOOOOOOOXXOXXXXX
XXOXOXOXOXOXOXXOXXOXOXXOXOXXXXXXXXXXXXXXOXXXXXXOXXXXXXOXXXXX
XOXOXOXOXOXOXOXXOOXOXXXOXOXXXOOOOOOOOOOXOXXXXXXOXXXXXXOXXXXX
XXOXXXXXXXXXXXOOXXXOXXXOXOXXXOXXXXXXXXOXOOOOOOOOOOOOOOOXXXXX
XXXOXXXOOOOOOOOOOOOXOXXOXOXXXOXXXXXXXXOXXXXXXXXXXXXXXXOXXXXX
XOOOOOOOXXXXXXXXXXXXXXXOXOXXXOXXXXXXXXOXOOOOOOOOOOXXXXOXXXXX
XOXXXXXXOOOOOOOOOOOOOOXOXOOOOOXXXXXXXXOXXXXXOXXXXOXXXXOXXXXX
XOOOOOOOOXXXXXXXXXXXXOXOXXXXXXXXXXXXXXOXXXOOOOOOOOXXXXOXXXXX
XXXXXXXXXXOOOOOOOOOOOOXOOOOOOXOOOOOOOOOXXXOXXXXXXXXXXXOXXXXX
XOOOOOOOOOXXXXXXXXXXXXXXXXXXOXOXXXXXXXXXXXOOOOOOOOOXXXOXXXXX
XOXXXOXXXXOOOOOOOOOOOOOOOXXXOXOOOOOOOOOXXXXXXXXXXXOXXXOXXXXX
XOXXXOXXXXOXXXXXXXXXXXXXOXXXOXXXXXXXXXOOOOOOOOOOOOOXXXOXXXXX
XOXXXOXXXXOXXXXXXXXXXXXXOXXXOOOOOOOOOXOXXXXXXXXXXXXXXXOXXXXX
XOXXXOXXXXOXXXXXXXXXXXXXOXXXXXXXXXXXOXOXXXXXOOOOOOOOOOOXXXXX
XOXXXOXXXXOXXXXXXXXXXXXXOXXXXXOOOOOOOXOXXXXXOXXXXXXXXXOXXXXX
XOXXXOXXXXOXXXXXXXXXXXXXOXXXXXOXXXXXOXOOOOOOOOOOOOXXXXOXXXXX
XOXXXOOOOXOXXXXXXXXXXXXXOXXXXXOXXXXXOXXXXXXXXXXXXOXXXXOXXXXX
XOXXXXXXOXOXXXXXXXXXXXXXOXXXXXOXXXXXOOOOOOOOOOXXXOXXOXOXXXXX
XXXXXXXXOXOXXXXXXXXXXXXXOXXXXXOXXXXXXXXXXXXXXOXXXOOOOXXXXXXX
XOOOOOOOOXOXXXXXXXXXXXXXOXXXXXOXXXXXXXXXXXXXXOXXXXXXOOOOOOOX
XOXXXXXXXXOXXXXXXXXXXXXXOXXXXXOXXXXXXXXXXXXXXOXXXXXXXXXXOXXX
XOOOOOOOOOOXXXXXXXXXXXXXOOOOOOOXXXXXXXXXXXXXXXOOOOOOOOOXOOZX
XXXXXXXXXXXXXXXXXXXXXXXXXXXXXXXXXXXXXXXXXXXXXXXXXXXXXXXXXXXX