XXXXXXXXXXXXXXXXXXXXXXXXXXXXXXXXXXXXXXXXXXXXXXXXXXXXXXXXXXXX
XOOOOOOXXXXXXXXXXXXXXXXXXOOOOOOOXXXXXXXXXXOOOOOOOOOOOOOOOOOX
XOXXXXOOOOOOOOOOXXXXXXXXXOXXXXXOXXXXXXXXXXOXXXXXXXXXXXXXXXOX
XOXXXXXXXXXXXXXOOOOOOOOOOXXXXXXOXXXXXXXXXXOXXXXXXXXXXXXXXXOX
XOXXXXXXXXXXXXXXXXXXXXXXXXXXXXXOXXXXXXXXXXOXXXXXXXXXXXXXXXOX
XOOOOOOOOOOOOOOOOOOOOXXXXXXXXXXOXXXXXXXXXXOXXXXXXXXXXXXXXXOX
XXXXXXXXXXXXXXXXXXXXOXXXXXXXXXXOOOOOOOOOOOOXXXXXXXXXXXXXXXOX
XXXXXXXXXXXXXXXXXXXXOXXXXXXXXXXXXXXXXXOXXXXXXXXXXXXXXXXXXXOX
XXXXXXXXXXXXXXXXXXXXOXXXXXXXXXXXOXXXXXOOOOOOOOOOOOOOOOOOOXOX
XXXXXXXXXXXXXXXXXXXXOXOOOOOOOOOOOXXXXXXXXXXXXXXXXXXXXXXXOXOX
XXXXXXXXXXXXXXXXXXXXOXXXXXXXXXXXOXXXXXXXXXXXXXXXXXXXXXXXOXOX
XXXOXOOOOOOOOOOOOOOOOXXXXXXXXXXXOOOOOOOOOOOOOOOOOOOOOXOOOXOX
XXXXXXXXXXXXXXXXXXXXXXXXXXXXXXXXOXXXXXXXXXXXXXXXXXXXXXOXXXOX
XOOOOOOOOOOOOOOOOOOOOOOOOOOOOOOOXOOOOOOOOOOOOOOOOOOOOOOXOOOX
XOXOXXXXXXXXXXXXXXXXXXXXXXXXXXXOXXXXXXXXXXXXXXXXXXXXXXXXOXXX
XOXOXXXXXXXXXXXXXOOOOOXXXXXXXXXOOOOOOOOOOOOOOOOOOOOOOOOOOXXX
XOXOOOOOOOXOXXXXXOXXXOXXXXXXXXXXXXXXXXXXXXXXXXXXXXXXXXXXXXXX
XOXXXXXXXXXOXXXXXOXXXOOOOOOOOOOOOOOOOOOOOOOOOOOOOOOXOOOOOOOX
XOXXXXXXXXXOXXXXXOXXXXXXXXXXXXXXXXXXXXXXXXXXXXXXXXOXXXXXXXOX
XOXXXOOOOOOOXXXXXOXXXXXXXXOOOOOOOOOOOOOOOOOXXXXXXXOXXXXXXXOX
XOXXXOXXXXOXXXXXXOXXXXXXXXOXXXXXXXXXXXXXXXOXXXXXXXOXXXXOOOOX
XOXXXOXXXXOXXXXXXOXXXXXXXXOXXXXXXXXXXXXXXOOXXXXXXXOXXXXOXXXX
XOXXXOXXXXOOOOOOXOXXXXXXXXOXXXXXXXXXXXXXXOXXOOOOOOOXXXXOXXXX
XOXXXOXXXXXXXXXXXOOOOOOOOOOXXXXXXXXXXXXXXOXXOXXXXXXXXXXOXXXX
XOXXXOOOOOOOOOOOOOXXXXXXXXXXXXXXXXXXXXXXXOXXOXXXXXXXXXXOXXXX
XOXXXXXXXXXXXXXXXOXXXOXXXXXXXXXXXXXXXXXXXOXXOXXXXXXXXXXOXXXX
XOOOOOOOOOOOOOOOOOXXXOOOOOOOXXXXXXXXXOOOOOOXOOOOOOOOOOOOOOOX
XXXXXXXXXXXXXXXXXXXXOOXXXXXXOOOOOOOOOXXXXOXXXXXXXXXXXXXXXOXX
XOOOOOOOOXXXXXXXXXXXOXXXXXXXOXXXXXXXXXXXXXXXXXXXXXXXXXXXXXOX
XXXXXXXXOXXXXXXXXXXXOXXXXXXXOXXXXOOOOOOOOOOOOOOOOOOOOOOOOOOX
XXXXXXXXOXXXXXXXXXXXOXXXXXXXOXXXXOXXXXXXXXXXXXXXXXXXXXXXXXOX
XXXXXXXOOOOOOOOOOOOOOXXXXXXXOXXXXOOOOOOOOOOOOOOOXOXXXXXXXXOX
XXXXXXXOXXXXXXXXXXXXOXXXXXXXOXXXXOXXXXXXXXXXXXXXXOXXXXXXXXOX
XXXXXXXOXXXXXXXXXXXXOXXXXXXXOXXXXOXOOOOOOOOOOOXXXOXXXXXXXXOX
XXXXXOOOXXXXXXXXXXXXOXXXXXXXOXXXXOXOXXXXXXXXXOXXXOOOOOOOOOOX
XXXXXOXXXXXXXXXXXXXXOXXXXXXXOXXXXOXOXXXXXXXXXOXXXXXXXXXXXXXX
XXXXXOXXOOOOOOOOOOOOOOOOOOOOOOOOOOX0XXXXXXXXXOOOOOOOOOOOXXXX
XOOOOOXXOXXXXXXXXXXXXXXXXXXXXXXXXXXXXXXXXXXXXXXXXXXXXXXOXXXX
XOXXXXXXOOOOOOOOOOOOOOOOOOOOOOOOOOOOOOOOOOOOOOOOOOOOOOOOOOZX
XXXXXXXXXXXXXXXXXXXXXXXXXXXXXXXXXXXXXXXXXXXXXXXXXXXXXXXXXXXX