XXXXXXXXXXXXXXXXXXXXXXXXXXXXXXXXXXXXXXXXXXXXXXXXXXXXXXXXXXXX
XOOOOOOOOOOOOOOOOOOOOOOOOOOXXXXXXOOOOOOOOOOOOXXXXXXXOOOOOOOX
XXXXXXXXXXXXXXXXXXXXXXXXXXOOOOOOOOXXXXXXXXXXXOOOOOXXOXXXXXOX
XOOOXXXXXXXXXXXXXXXXXXXXXXOXXXXXXXXXXXXXXXXXXXXXXXOOOXXOXXOX
XOXOXXXXXXXXXXXXXXXXXXXXXXOOOOOOOOOOOOOOOOOOOOOOOOXXXXXOXXOX
XOXOOOOOOOOOOOOOOOOOOOOOOOXXXXXXXXXXXXXXXXXXXXXXXXOXXXXOXXOX
XOXXXXXXXXXXXOXXXXXXXXXXXOXXXXXXXXXXXXXXXXXXXXXXXXOXXXXOXXOX
XOXXXXXXXXXXXOXOOOOOOOXXXOXXXXXXXXXXXXXXXXXXXXXXXXOXXXXOXXOX
XOXXXXXXXXXXXOXOXXOXXOXXXOXXOOOOOOOOOOOOOOOOOOOOOOOXXXXOXXOX
XOXXXXXXXXXXXOXOXXOXXOXXXOXXOXXXXXXXXXXXXXXXXXXXXXXXXXXOXXOX
XOXXXXXXXXXXXOXOXXOXXOXXXOXXOXOOOOOOOOOOOOOOOOOOOOOOOOOOXXOX
XOXXXXXXXXXXXOXOXXOXXOXXXOXXOXXXXXXXXXXXXXXOXXXXXXXXXXXXXXOX
XOXOOOOOOOOOOOXOXXOXXOXXXOXXOXXXXXXXXXXXXXXOOOOOOOOOOOOOXXOX
XOXOXXXXXXXXXXXOOOOXXOXXXOXXOOOOOOOOOOOOOXXXXXXXXXXXXXXOXXOX
XOXOXXXXXXXXXXXXXXXXXXOXXOXXXXXXXXXXXXXXOXXXXXXXXXXXXXXOXXOX
XOXOOOOOOOOOOOOOOOOOOOXXXOXOOOOOOOOOOOOXOXXXXXXXXXXXXXXOXXOX
XOXOXXXXXXXXXXXXXXXXXXOXXOXXXXXXXXXXXXOXOXXXXXXXXXXXXXXOXXOX
XOXOXOOOOOOOOOOXXXXXXOXXXOXXXXXXXXXXXXOXOXXXXXXXXXXXXXXOXXOX
XOXOXXXXXXXXXXOXXXXXXOXXXOXXOOOOOOOOOOOXOOOOOOOOOOOOOOOOXXOX
XOXOOOOOOOOOOXOXXXXXXOXXXOXXOXXXXXXXXXXXOXXXXXXXXXXXXXXXXXOX
XOXXXXXXXXXXOXOXXXXXXOXXXOXXOXXXXXXXXXXXOXXXXXXXXXXXXXXXXXOX
XOXXXXXXXXXXOXOXXXXXXOXXXOXXOXXXXXXXXXXXOXXXXXXXXXXXXXXXXXOX
XOXXXXXXXXXXOXOXXXXXXOXXXOXXOXXXXXXXXXXXOXXXXXXXXXXXXXXXXXOX
XOXXXXXXXXXXOXOOOOOOOOXXXOXXOXXXXXXOOOOOXOOOOOOOOOOOOOOOOXOX
XOXXXXXXXXXXOXXXXXXXXXXXXOXXOXXXXXOXXXXXXXXXXXXOXXXXXXXXXXOX
XOOOOOOOOOOOXOOOOOOOOOOOOOXXOOOOOOXXXXXXXXXXXXXOXXXXXXXXXXOX
XOXOXXXXXXXXOXXXXXXXXXXXXOXOXXXXXXXXXXXXXXXXXXXOXXXXXXXXXXOX
XOXOXXXXXXXXOXXXXXXXXXXXXOXOXXXXXXXXXXXXOOOOOOOOXXXXXXXXXXOX
XOXOXXXXXXXXOXXXXXXXXXXXXOXOXXXXXXXXXXXXXXXXXXXXXXXXXXXXXXOX
XOXOXXXXXXXXOOOOOOOOOOOOOOXOOOOOOOOOOOOOOOOOOOOOOOOOOOOOOXOX
XOXOXXXXXXXXOXXXXXXXXXXXXOXXXXXXXXXXXXXXXXXXXXXXOXXXXXXXXXOX
XOXOXXXXXXXXOXXXXXXXXXXXXOXXXXXXXXXXXXXXXXXXXXXXOXXXXXXXXXOX
XOXOXXXXXXXXOXXXXXXXXXXXXOXXXXXXXOOOOOOOOOOOOOOOOXXXXXXXXXOX
XOXOXXXXXXXXOXXXXXXXXXXXXOXXXXXXXOXXXXXXXXXXXXXXXXXXXXXXXXOX
XOXOXXXXXXXXOXXXXXXXXXXXXOXXXXXXXOOOOOOOOOXXXXXXXXXXXXXXXXOX
XOXOXXXXXXXXOXXXXXXXXXXXXOXXXXXXXXXXXXXXXXXXXXXXXXXXXXXXXXOX
XOXOOOOOOOOOOXXXXXXXXXXXXOOOOOOOOOOOOOOOOOOOOOOOOOOOOOOOOOOX
XOXXXXXXXXXXXXXXXXXXXXXXXXXXXXXXXXXXXXXXXXXXXXXXXXXXXXXXXXXX
XOOOOOOOOOOOOOOOOOOOOOOOOOOOOOOOOOOOOOOOOOOOOOOOOOOOOOOOOOZX
XXXXXXXXXXXXXXXXXXXXXXXXXXXXXXXXXXXXXXXXXXXXXXXXXXXXXXXXXXXX