XXXXXXXXXXXXXXXXXXXXXXXXXXXXXXXXXXXXXXXXXXXXXXXXXXXXXXXXXXXX
XXOOOXOOOOOOOXXXXXXXXXXXXXXXXXXXXXXXOOOOOOOOOXOOOOOOOOOOOOXX
XOXXOXXXXXXXOOOOOOOOOOOOOOOOOOOOOOOOOXXXXXXXOXXOXXXXXXXXXOXX
XOOOOOOOOOOXXXXXXXXXXOXXXXXXXXXXXXXXXXXXXXXXOXXOXXXXXXXXXOXX
XXXOXXXXXXOXXXXXXXXXXOXXXXXXXXOOOOOXXXXXXXXXOXXOXXXXXXXXXOXX
XXXOXXOXXXOXXXXXXXXXXOXXXXXXXXXXXXOXXXXXXXXXOOOOOOOOOOOOOOOX
XXXOXXOXXXOXXXXXXXXOOOXXXXXXXXXXOOOOOOOOOOOOOOOOXXXXXXXXXXXX
XXXOXXOXXXOXXOOOOOXOXXXOOOOOOOOOOXXXXXXXXXXXXXXOXXXXXXXXXXXX
XXXOXXOXXXOXXOXXXOXOXXXXXXXXXXXXOOOOOOOOOOOOOOXOXXXXXXXXXXXX
XXXOOOOOOXOXXOXXXOXOOOOOOOOOOOOOOOXXXXXXXXXXXXXOOOOOOOOOOOXX
XXXXXXOXXXOXXOXXXOXXXXXXXXXXXXXXXOXXXXXXXXXXXXXXXXXXXXXXOXXX
XXXXXXOXXXOOOOXXXOXXXXXXXXXXXXXXXOOOOOOOOOXXXXXXXXXXXXXXOXXX
XXXXXXOXXXXXOXXXXOOOOOOOOOOOOOOOOOXXXXXXXOOOOOXXXXXXXXXXOXXX
XOOOOOOXXXXXOXXXXOXXXXXXXXXXXXXXXXXXXXXXXXXXXXOOOOOOOOXXOXXX
XXXXXXOXXXXXOXXXXOOOOOOOOOXXXXXXXXXXXXXXXXXXXXXXXXXXXXOOOXXX
XXXXXXOOOOOOOOOOOXXXXXXXXOXXXXOOOOOOOOXXOOOOOOOOOOOOOOOXXXXX
XXXXXXXXXXXXXXXXOOOOOOOXOOOOOOXXXXXXOXXOXXXXXXXXXXXXXOXXXXX
XXXXXXXXXXXXXXXXXXXXXXOOXOXXXXXXXXXXXOOOOXOOOOOOOOOOXXOXXXXX
XXXXXXXXXXXXXXXXXXXXXXXOXOXXXXXXXXXXXXXXOXXXXXXOXXXXXXOXXXXX
XXXXXXXXXXXXXXXXXXXXXXXOXOXXXOOOOOOOOOOXOXXXXXXOXXXXXXOXXXXX
XXXXXXXXXXXXXXXXXXXXXXXOXOXXXOXXXXXXXXOXOOOOOOOOOOOOOOOXXXXX
XXXXXXXXXXXXXXXXXXXXXXXOXOXXXOXXXXXXXXOXXXXXXXXXXXXXXXOXXXXX
XXXXXXXXXXXXXXXXXXXXXXXOXOXXXOXXXXXXXXOXOOOOOOOOOOXXXXOXXXXX
XXXXXXXXXXXXXXXXXXXXXXXOXOOOOOXXXXXXXXOXXXXXOXXXXOXXXXOXXXXX
XXXXXXXXXXXXXXXXXXXXXXXOXXXXXXXXXXXXXXOXXXOOOOOOOOXXXXOXXXXX
XXXXXXXXXXXXXXXXXXXXXXXOOOOOOXOOOOOOOOOXXXOXXXXXXXXXXXOXXXXX
XXXXXXXXXXXXXXXXXXXXXXXXXXXXOXOXXXXXXXXXXXOOOOOOOOOXXXOXXXXX
XXXXXXXXXXXXXXXXXXXXXXXXXXXXOXOOOOOOOOOXXXXXXXXXXXOXXXOXXXXX
XXXXXXXXXXXXXXXXXXXXXXXXXXXXOXXXXXXXXXOOOOOOOOOOOOOXXXOXXXXX
XXXXXXXXXXXXXXXXXXXXXXXXXXXXOOOOOOOOOXOXXXXXXXXXXXXXXXOXXXXX
XXXXXXXXXXXXXXXXXXXXXXXXXXXXXXXXXXXXOXOXXXXXOOOOOOOOOOOXXXXX
XXXXXXXXXXXXXXXXXXXXXXXXXXXXXXXXXXXXOXOXXXXXOXXXXXXXXXOXXXXX
XXXXXXXXXXXXXXXXXXXXXXXXXXXXXXXXXXXXOXOOOOOOOOOOOOXXXXOXXXXX
XXXXXXXXXXXXXXXXXXXXXXXXXXXXXXXXXXXXOXXXXXXXXXXXXOXXXXOXXXXX
XXXXXXXXXXXXXXXXXXXXXXXXXXXXXXXXXXXXOOOOOOOOOOXXXOXXOXOXXXXX
XXXXXXXXXXXXXXXXXXXXXXXXXXXXXXXXXXXXXXXXXXXXXOXXXOOOOXXXXXXX
XXXXXXXXXXXXXXXXXXXXXXXXXXXXXXXXXXXXXXXXXXXXXOXXXXXXOOOOOOOX
XXXXXXXXXXXXXXXXXXXXXXXXXXXXXXXXXXXXXXXXXXXXXOXXXXXXXXXXOXXX
XXXXXXXXXXXXXXXXXXXXXXXXXXXXXXXXXXXXXXXXXXXXXXOOOOOOOOOXOOZX
XXXXXXXXXXXXXXXXXXXXXXXXXXXXXXXXXXXXXXXXXXXXXXXXXXXXXXXXXXXX